9:9
128 64 16 17 32 0 0 0 0
32 0 0 32 0 0 0 0 0
0 16 16 17 17 0 0 0 0
0 80 50 96 112 0 0 0 0
0 96 0 82 64 0 0 0 0
0 0 55 0 0 0 0 0 0
0 0 0 19 0 0 0 0 70 
0 0 0 0 0 0 0 0 0
0 0 0 0 0 0 0 0 0