9:9
128 58 16 17 32 0 0 0 0
0 0 0 0 0 0 0 0 0
0 0 0 32 0 0 0 0 0
0 16 16 17 17 0 0 0 0
0 80 0 96 112 0 0 0 0
0 0 0 0 0 0 0 0 63
112 96 0 82 0 0 0 0 0
0 0 0 0 0 0 0 0 0 
0 0 0 0 0 0 0 0 0
