9:9
0 80 16 17 32 0 0 0 0
0 0 17 32 80 0 0 0 0
0 16 16 17 17 0 0 0 0
64 80 26 96 112 0 0 0 0
112 96 35 82 18 0 0 0 0
0 0 0 0 0 0 0 60 0
25 80 48 96 112 0 0 0 0
0 0 0 0 0 0 0 0 0
112 96 0 82 64 0 0 28 0
