9:9
128 64 16 17 32 0 0 0 0
32 0 0 32 0 0 0 0 0
0 16 16 17 17 0 0 0 0
0 80 54 96 112 0 0 0 0
0 96 0 82 64 0 0 0 0
0 0 59 0 0 0 0 0 0
0 0 0 19 0 0 0 70 0
0 0 0 0 0 0 0 0 0
0 0 0 0 0 0 0 0 0