9:9

128 0 16 17 32 0 0 0
0 0 0 0 0 0 0 0 0
0 0 25 32 0 0 0 48 0
0 16 16 17 17 0 0 0 0
0 0 0 0 0 0 0 0 0
64 80 53 96 112 0 0 0 0
0 0 0 0 0 0 0 0 0
0 0 0 0 0 0 0 0 0 
